111111111111111111111111111111111111111111111111111111111111111111111111111111111111111111111111111111111111111111111111111111111111111111111111111111111111111111111111111111111111111111111111111111111111111111111111111111111111111111111111111111111111111111111111111111111111111111111111111111111111111111111111111111111111111111111111111111111111111111111111111111111111111111111111111111111111111
1.............................................................................................................................................................................................................................................................................................................................................................................................................1
1.............................................................................................................................................................................................................................................................................................................................................................................................................1
1............................................................................................................................................................................111111111111111..................................................................................................................................................................................................................1
1.............................................................................................................................................................................................................................................................................................................................................................................................................1
1.............................................................................................................................................................................................................................................................................................................................................................................................................1
1......................................................................................................................................................................................................................................A...............................11111111111111111111...................................................................................................................1
1................................................................................................................................................................................................................................1111111111111................................................................................................................................................................1
1.............................................................................................................................................................................................................................................................................................................................................................................................................1
1.............................................................................................................................................................................................................................................................................................................................................................................................................1
1.............................................................................................................................................................................................................................................................................................................................................................................................................1
1.............................................................................................................................................................................................................................................................................................................................................................................................................1
1.........................................................................................................................................................................................................A...................................................................................................................................................................................................1
1.............................................................................................................................................................S....................................111111111111111............................................................................................................................................................................................1
1.......................................................................................................................................................111111111111111....................................................................................................................111111111111111111111..............................................................................................1
1..............................................................................................................................................111............................................................................................................................................................................................................................................................1
1.............................................................................................................................A...............................................................................................................................................................................................................................................................................1
1......................................................................................................................11111111111111.........................................................................................................................................................................................................................................................................1
1.............................................................................................................................................................................................................................................................................................................................................................................................................1
1................................................................................................................111..........................................................................................................................................................................................................................................................................................1
1......................................................................................................S......................................................................................................................................................................................................................................................................................................1
1.................................................................................................111111111...................................................................................................................................................................................................................................................................................................1
1............................................................................A............111.................................................................................................................................................................................................................................................................................................................1
1......................................................................1111111111111..........................................................................................................................................................................................................................................................................................................................1
1.........................................................................................................................................................................................S...................................................................................................................................................................................................................1
1.....................................................................................................................................................................................11111111................................................................................................................................................................................................................1
1.............................................................................................................................................................................................................................................................................................................................................................................................................1
1.........................................................S...................................................................................................................................................................................................................................................................................................................................................1
1.......P............................................11111111111..............................................................................................................................................................................................................................................................................................................................................1
1.............................................................................................................................................................................................................................................................................................................................................................................................................1
1.................................A...........................................................................................................................................................................................................................................................................................................................................................................1
1.............................11111111.....111................................................................................................................................................................................................................................................................................................................................................................1
1.............................................................................................................................................................................................................................................................................................................................................................................................................1
1.............................................................................................................................................................................................................................................................................................................................................................................................................1
1.............................................................................................................................................................................................................................................................................................................................................................................................................1
1.............................................................................................................................................................................................................................................................................................................................................................................................................1
1....111111111111111111.......................................................................................................................................................................................................................................................................................................................................................................................1
1.............................................................................................................................................................................................................................................................................................................................................................................................................1
1.................A...............................................C...............................S................................................S......................................................................C.........................................C.........................................................................................................................................1
111111111111111111111111111111111111111111111111111111111111111111111111111111111111111111111111111111111111111111111111111111111111111111111111111111111111111111111111111111111111111111111111111111111111111111111111111111111111111111111111111111111111111111111111111111111111111111111111111111111111111111111111111111111111111111111111111111111111111111111111111111111111111111111111111111111111111