111111111111111111111111111111111111111111111111111111111111111111111111111111111111111111111111111111111111111111111111111111111111111111111111111111111111111111111111111111111111111111111111111111111111111111111111111111111111111111111111111111111111111111111111111111111111111111111111111111111111111111111111111111111111111111111111111111111111111111111111111111111111111111111111111111111111111
1.............................................................................................................................................................................................................................................................................................................................................................................................................1
1.............................................................................................................................................................................................................................................................................................................................................................................................................1
1............................................................................................................................................................................111111111111111..................................................................................................................................................................................................................1
1.............................................................................................................................................................................................................................................................................................................................................................................................................1
1.............................................................................................................................................................................................................................................................................................................................................................................................................1
1......................................................................................................................................................................................................................................................................11111111111111111111...................................................................................................................1
1................................................................................................................................................................................................................................1111111111111................................................................................................................................................................1
1.............................................................................................................................................................................................................................................................................................................................................................................................................1
1.............................................................................................................................................................................................................................................................................................................................................................................................................1
1.............................................................................................................................................................................................................................................................................................................................................................................................................1
1.............................................................................................................................................................................................................................................................................................................................................................................................................1
1.............................................................................................................................................................................................................................................................................................................................................................................................................1
1..................................................................................................................................................................................................111111111111111............................................................................................................................................................................................1
1.......................................................................................................................................................111111111111111....................................................................................................................111111111111111111111..............................................................................................1
1..............................................................................................................................................111............................................................................................................................................................................................................................................................1
1.............................................................................................................................................................................................................................................................................................................................................................................................................1
1......................................................................................................................11111111111111.........................................................................................................................................................................................................................................................................1
1.............................................................................................................................................................................................................................................................................................................................................................................................................1
1................................................................................................................111..........................................................................................................................................................................................................................................................................................1
1.............................................................................................................................................................................................................................................................................................................................................................................................................1
1.................................................................................................111111111...................................................................................................................................................................................................................................................................................................1
1.........................................................................................111.................................................................................................................................................................................................................................................................................................................1
1......................................................................1111111111111..........................................................................................................................................................................................................................................................................................................................1
1.............................................................................................................................................................................................................................................................................................................................................................................................................1
1.....................................................................................................................................................................................11111111................................................................................................................................................................................................................1
1.............................................................................................................................................................................................................................................................................................................................................................................................................1
1.............................................................................................................................................................................................................................................................................................................................................................................................................1
1.......................................2222.........11111111111..............................................................................................................................................................................................................................................................................................................................................1
1.............................................................................................................................................................................................................................................................................................................................................................................................................1
1.............................................................................................................................................................................................................................................................................................................................................................................................................1
1.............................11111111.....111................................................................................................................................................................................................................................................................................................................................................................1
1..P..........................................................................................................................................................................................................................................................................................................................................................................................................1
1.............................................................................................................................................................................................................................................................................................................................................................................................................1
1.............................................................................................................................................................................................................................................................................................................................................................................................................1
1.............................................................................................................................................................................................................................................................................................................................................................................................................1
1.............................................................................................................................................................................................................................................................................................................................................................................................................1
1.............................................................................................................................................................................................................................................................................................................................................................................................................1
1........................................S...S.........................A.........A............................................................................................................................................................................................................................................................................................................................1
111111111111111111111111111111111111111111111111111111111111111111111111111111111111111111111111111111111111111111111111111111111111111111111111111111111111111111111111111111111111111111111111111111111111111111111111111111111111111111111111111111111111111111111111111111111111111111111111111111111111111111111111111111111111111111111111111111111111111111111111111111111111111111111111111111111111111